9 9
# #######
# #######
#    ## #
## # ## #
## #    #
##### ###
##      #
## # ## #
####### #
$